#######
#     #
# ### #
# #E  #
##### #
#S  # #
#######
